#########........######
########....#.#########
######...####.#########
#######...............#
####################...
################......#
####################.##
####################.##
###################..##
###################.###
